NO textures/simonkraft/respawn_anchor_side0.xpm
EA textures/simonkraft/respawn_anchor_side2.xpm
SO textures/simonkraft/respawn_anchor_side4.xpm
WE textures/simonkraft/respawn_anchor_side3.xpm
DO textures/door/door_open.xpm
LA textures/lamp/lamp1.xpm textures/lamp/lamp2.xpm textures/lamp/lamp3.xpm textures/lamp/lamp4.xpm textures/lamp/lamp5.xpm

F 30,20,10
C 10,10,30

11111111111111111111111111111111111111111111111
100000000000000000000000000000D0000000000000000
10111111111111111000000011111111111111111111111
1010000000000000101000001
1010111111111110101000001
1010100000000010101000001
1010101111111010101000101
1010101L00001010101000101
10101011D11110101010001D1
1010100000000010101000001
101011111111D110101000001
1010000000000000101000001
11111111D1111111101111111
100000000000000000111111111111111
10000000N000000000000000000000001
111111111111111111111111111111111
