NO textures/torch/torch1_wall_1.xpm
NO textures/torch/torch2_wall_1.xpm
NO textures/torch/torch3_wall_1.xpm
SO textures/torch/torch2_wall_2.xpm
SO textures/torch/torch3_wall_2.xpm
SO textures/torch/torch1_wall_2.xpm
WE textures/torch/torch3_wall_3.xpm
WE textures/torch/torch1_wall_3.xpm
WE textures/torch/torch2_wall_3.xpm
EA textures/torch/torch1_wall_3.xpm
EA textures/torch/torch2_wall_3.xpm
EA textures/torch/torch3_wall_3.xpm

F 184,113,39
C 51,198,227

11111111111111111111111111111
10000000001100000000000000001
10110000011100000001111011111
11111111110000000000000000011111
        10110000011100000000000011111
        1000000000110000011110111111
11111111111111011100000010001
11110111111111011101010010001
11000000110101011100000010001
11111111000000001100000010001
       10000000000000001100011111111
    11110000110101000000000001111
11111111110101000000000000001
10000000001100000100000010001
100000000    0 0000000000000011001
10000000111100010000N00001001
100000001  100110101110000001
10000000111110000001 10100001
11111111111111111111 11111111
