NO textures/wolfenstein/grey_stone.xpm
SO textures/wolfenstein/purple_stone.xpm
WE textures/wolfenstein/red_brick.xpm
EA textures/wolfenstein/wood.xpm
DO textures/door/door_open.xpm
LA textures/lamp/lamp1.xpm textures/lamp/lamp2.xpm textures/lamp/lamp3.xpm textures/lamp/lamp4.xpm textures/lamp/lamp5.xpm

F 50,50,50
C 135,206,235

1111111111111111
1000000000000001
10L00000000000L1
100000000111D111
1000000N00000001
1000000000000001
10L00000000000L1
1000000000000001
1111111111111111