NO textures/test/north.xpm
SO textures/test/south.xpm
WE textures/test/west.xpm
EA textures/test/east.xpm
DO textures/test/door.xpm

F 40,40,40
C 170,170,170

1111111
1S00001
100D001
1000001
1111111
