NO textures/test/north.xpm
SO textures/test/south.xpm
WE textures/test/west.xpm
EA textures/test/east.xpm

F 40,40,40
C 180,180,180

1111111
1S00001
1110111
1000
1111111
